..#.......
#......#..
#..#......
..##......
......##..
.##.......
.........#
..##...#..
.##....#.#
.......#..